{
    "w": 11,
    "h": 6,
    "type": [[5,1,1,1,2,1,1,2,3,1,1],
             [0,1,1,1,2,1,1,2,3,1,1],
             [0,1,1,1,2,1,1,2,3,1,1],
             [0,1,1,1,2,5,1,2,3,1,1],
             [0,1,1,1,1,5,1,2,3,1,1],
             [0,0,1,1,2,5,1,2,3,1,1]],

    "height": [[0,0,0,0,0,0,0,0,0,0],
        [0,0,0,0,0,0,0,0,0,0],
        [0,0,0,0,0,0,0,0,0,0],
        [0,0,0,0,0,0,0,0,0,0],
        [0,0,0,0,0,0,0,0,0,0],
        [0,0,0,0,0,0,0,0,0,0]]
}