{
    "w": 20,
    "h": 25,
    "tileSize": 64,
    "type": [[5,1,1,1,2,1,1,2,3,1,1,0,0,0,0,0,0,0,0,0],
             [0,1,1,1,2,1,1,2,3,1,1,0,0,0,0,0,0,0,0,0],
             [0,1,1,1,2,1,1,2,3,1,1,0,0,0,0,0,0,0,0,0],
             [0,1,1,1,2,5,1,2,3,1,1,0,0,0,0,0,0,0,0,0],
             [0,1,1,1,1,5,1,2,3,1,1,0,0,0,0,0,0,0,0,0],
             [0,0,1,1,2,5,1,2,3,1,1,0,0,0,0,0,0,0,0,0],
        [0,0,1,1,2,5,1,2,3,1,1,0,0,0,0,0,0,0,0,0],
        [0,0,1,1,2,5,1,2,3,1,1,0,0,0,0,0,0,0,0,0],
        [0,0,1,1,2,5,1,2,3,1,1,0,0,0,0,0,0,0,0,0],
        [0,0,1,1,2,5,1,2,3,1,1,0,0,0,0,0,0,0,0,0],
        [0,0,1,1,2,5,1,2,3,1,1,0,0,0,0,0,0,0,0,0],
        [0,0,1,1,2,5,1,2,3,1,1,0,0,0,0,0,0,0,0,0],
        [0,0,1,1,2,5,1,2,3,1,1,0,0,0,0,0,0,0,0,0],
        [0,0,1,1,2,5,1,2,3,1,1,0,0,0,0,0,0,0,0,0],
        [0,0,1,1,2,5,1,2,3,1,1,0,0,0,0,0,0,0,0,0],
        [0,0,1,1,2,5,1,2,3,1,1,0,0,0,0,0,0,0,0,0],
        [0,0,1,1,2,5,1,2,3,1,1,0,0,0,0,0,0,0,0,0],
        [0,0,1,1,2,5,1,2,3,1,1,0,0,0,0,0,0,0,0,0],
        [0,0,1,1,2,5,1,2,3,1,1,0,0,0,0,0,0,0,0,0],
        [0,0,1,1,2,5,1,2,3,1,1,0,0,0,0,0,0,0,0,0],
        [0,0,1,1,2,5,1,2,3,1,1,0,0,0,0,0,0,0,0,0],
        [0,0,1,1,2,5,1,2,3,1,1,0,0,0,0,0,0,0,0,0],
        [0,0,1,1,2,5,1,2,3,1,1,0,0,0,0,0,0,0,0,0],
        [0,0,1,1,2,5,1,2,3,1,1,0,0,0,0,0,0,0,0,0],
        [0,0,1,1,2,5,1,2,3,1,1,0,0,0,0,0,0,0,0,0],
            [0,0,1,1,2,5,1,2,3,1,1,0,0,0,0,0,0,0,0,0]],

    "height": [[100,0,10,5,0,0,0,0,0,0,0,0,0,0,0,0,0,0,0,0],
        [10,0,0,0,10,20,10,0,0,0,0,0,0,0,0,0,0,0,0,0],
        [20,0,0,0,10,0,10,0,0,0,0,0,0,0,0,0,0,0,0,0],
        [30,0,0,0,0,0,0,0,0,0,0,0,0,0,0,0,0,0,0,0],
        [40,0,0,0,20,22,23,0,0,0,0,0,0,0,0,0,0,0,0,0],
        [30,0,0,0,0,21,12,11,0,0,0,0,0,0,0,0,0,0,0,0],
        [20,0,0,0,33,0,0,11,12,0,0,0,0,0,0,0,0,0,0,0],
        [10,0,0,0,2,22,0,10,10,10,0,0,0,0,0,0,0,0,0,0],
        [4,0,0,0,0,1,0,0,0,0,0,0,0,0,0,0,0,0,0,0],
        [0,0,0,0,0,0,0,0,0,0,0,0,0,0,0,0,0,0,0,0],
        [0,0,0,0,0,0,0,0,0,0,0,0,0,0,0,0,0,0,0,0],
        [0,0,0,0,0,0,0,0,0,0,0,0,0,0,0,0,0,0,0,0],
        [0,0,0,0,0,0,0,0,0,0,0,0,0,0,0,0,0,0,0,0],
        [0,0,0,0,0,0,0,0,0,0,0,0,0,0,0,0,0,0,0,0],
        [0,0,0,0,0,0,0,0,0,0,0,0,0,0,0,0,0,0,0,0],
        [0,0,0,0,0,0,0,0,0,0,0,0,0,0,0,0,0,0,0,0],
        [0,0,0,0,0,0,0,0,0,0,0,0,0,0,0,0,0,0,0,0],
        [0,0,0,0,0,0,0,0,0,0,0,0,0,0,0,0,0,0,0,0],
        [0,0,0,0,0,0,0,0,0,0,0,0,0,0,0,0,0,0,0,0],
        [0,0,0,0,0,0,0,0,0,0,0,0,0,0,0,0,0,0,0,0],
        [0,0,0,0,0,0,0,0,0,0,0,0,0,0,0,0,0,0,0,0],
        [0,0,0,0,0,0,0,0,0,0,0,0,0,0,0,0,0,0,0,0],
        [0,0,0,0,0,0,0,0,0,0,0,0,0,0,0,0,0,0,0,0],
        [0,0,0,0,0,0,0,0,0,0,0,0,0,0,0,0,0,0,0,0],
        [0,0,0,0,0,0,0,0,0,0,0,0,0,0,0,0,0,0,0,0],
        [0,0,0,0,0,0,0,0,0,0,0,0,0,0,0,0,0,0,0,0]]
}